42  27
o o o o o o o o o o o o o o o o o o o o o o o o o o o o o o o o o o o o o o o o o o
o e e e e e e e e e e e e e e e e e e e e e e e e e e e e e e e e e e e e e e e e o
o e e e e e e e e e e e e e e e e e e e e e e e e e e e e e e e e e e e e e e e e o
o e e e e e e e o o o o o o o o o o o e e e e e o o o o o o o o o o e e e e e e e o
o e e e e e e e e e e e e e o e e e e e e e e e e e e e o e e e e e e e e e e e e o
o e e e e e e e e e e e e e o e e e e e e e e e e e e e o e e e e e e e e e e e e o
o o e e o o o e e e e e e e o e e e e o e e e o e e e e o e e e e e e o o o e e o o
o e e e e e o e e e e e e o e e e e e o e e e o e e e e e o e e e e e o e e e e e o
o e e e e e o e e e e e o e e e e e e e o e o e e e e e e e o e e e e o e e e e e o
o e e e r e o e e e e e e e e e e e e e e o e e e e e e e e e e e e e o e b e e e o
o e e e e e o e e e o e e e o o o e e e e o e e e e o o o e e e o e e o e e e e e o
o e e e r e o e e e o e e o e e e o e e e o e e e o e e e o e e o e e o e b e e e o
o e e e e e o e e e e e e e e e e o e e e o e e e o e e e e e e e e e o e e e e e o
o e e e r e o e e e e e e e e e e o o o o o o o o o e e e e e e e e e o e b e e e o
o e e e e e o e e e e e e e e e e o e e e o e e e o e e e e e e e e e o e e e e e o
o e e e r e o e e e o e e o e e e o e e e o e e e o e e e o e e o e e o e b e e e o
o e e e e e o e e e o e e e o o o e e e e o e e e e o o o e e e o e e o e e e e e o
o e e e r e o e e e e e e e e e e e e e e o e e e e e e e e e e e e e o e b e e e o
o e e e e e o e e e e e o e e e e e e e o e o e e e e e e e o e e e e o e e e e e o
o e e e e e o e e e e e e o e e e e e o e e e o e e e e e o e e e e e o e e e e e o
o o e e o o o e e e e e e e o e e e e o e e e o e e e e o e e e e e e o o o e e o o
o e e e e e e e e e e e e e o e e e e e e e e e e e e e o e e e e e e e e e e e e o
o e e e e e e e e e e e e e o e e e e e e e e e e e e e o e e e e e e e e e e e e o
o e e e e e e e o o o o o o o o o o o e e e e e o o o o o o o o o o e e e e e e e o
o e e e e e e e e e e e e e e e e e e e e e e e e e e e e e e e e e e e e e e e e o
o e e e e e e e e e e e e e e e e e e e e e e e e e e e e e e e e e e e e e e e e o
o o o o o o o o o o o o o o o o o o o o o o o o o o o o o o o o o o o o o o o o o o